25,17,26,17,17,16,15,17,17,17,17,17
17,14,14,14,17,16,17,17,14,14,25,17
17,30,14,14,14,17,17,14,14,14,17,17
17,14,17,16,14,14,14,14,16,17,17,17
17,14,17,16,16,14,14,16,16,17,17,17
25,17,17,17,14,25,17,14,15,16,17,16
16,16,16,15,14,17,25,14,17,17,17,25
17,17,17,16,16,14,14,16,16,17,14,17
17,17,17,16,14,14,14,14,16,17,14,17
17,17,14,14,14,17,17,14,14,14,31,17
17,25,14,14,17,17,16,17,14,14,14,17
17,17,17,17,17,15,16,17,17,26,17,25
