24,14,24,25,3,0,1,8,23,23,23,23
24,30,26,24,4,11,12,9,22,22,26,23
24,14,14,24,23,4,9,24,24,24,22,23
24,14,14,25,23,23,25,14,14,14,24,23
24,14,14,24,23,24,14,14,14,14,14,24
24,14,14,23,24,24,24,14,14,14,14,24
24,14,14,14,14,24,24,24,23,14,14,24
24,14,14,14,14,14,24,23,24,14,14,24
23,24,14,14,14,25,23,23,25,14,14,24
23,22,24,24,24,2,7,23,24,14,14,24
23,26,22,22,2,10,13,7,24,26,31,24
23,23,23,23,3,1,0,8,25,24,24,24
